NO ./textures/north.xpm
SO ./textures/south.xpm
WE ./textures/west.xpm
EA ./textures/east.xpm

F 220,100,0
C 135,206,235

111111111111111111111111111
1000000000E0000000000000001
110101010101101010101010101
101010101010111101010101011
100000000000000000000000001
111111111111111111111111111
111001111000111100011000111
111101111110111111011110111
111101111000111100011110111
111101111110111111011110111
111101111000111100011110111
111111111111111111111111111
110000000000000000000000011
111110000000000000000011111
111111110000000000011111111
111111111111111111111111111
