NO ./textures/north.xpm
SO ./textures/south.xpm
WE ./textures/west.xpm
EA ./textures/east.xpm

F 02,0,0
C 01,0,0

111111111111111111111111111
1000000000E0000000000000001
110101010101101010101010101
101010101010121101010101011
100000000000000000000000001
111121111121111112111121111
111001111000111100011000111
111101111110111111011110111
111101111000111100011110111
111101111110111111011110111
111101111000111100011110111
111111111111111111111111111
