NO ./textures/north.xpm
SO ./textures/south.xpm
WE ./textures/west.xpm
EA ./textures/east.xpm

F 220   ,   100,0
C 135,206,  235

1111111
1012101
11100E1
1460061
1111111
